|#!!!!%!!!!%!!!#!#!!!!%!!!!!!\
|@$$$^$$$$$$$$$$*$$$$$$@$$$$$\
|(№$$$№$$)$$$$$$$$$$$$$)$$$$$\
|$$$$$$$$$$$$$$$$$$$$$+$$$$$$\
|$$$$)$$$$$$)$$$$$$$$$$$$$$$$\
|^$$№$$$$$$$$$<>$$$$$$$$$$$$$\
|$)$$$$$$$$$$$$$)$$$$$$$$$$$$\
|$$$$$$$$$$$$$$№$$$$№$$$$$$$$\
|№$$№$$$$$$$$Q$$A$$$$$$$+$$$$\
|$$$$$$$$№$$$$$$$$$$$$$$$$$$$\
|($$$$$$$$№$$$+$$$$$$$$^$$$$$\
|$$$$$$$$$$$$$$$$)$$$$$$$$$$$\
|@$$$$$$$$$$$$$$$$$$$$$$$$$$$\
|$$$$$$+$$$$$$$$$$$$$$$$$$$$$\
|$$$$$$$$$$$$$$№$$$$$$+$$$$$$\
|$$$$$$$$$$$$$$@$$$$$$$$$$$$)\
|!!!!!!!!!!!!!!!!!!!!!!!!!!!!\