|#!!!!%!!!!!!!!#!#!!!!&!!!!!!\
|@$$$^$$$$$$$$$$*$$$$$$@$$$$$\
|(№$$$№$$)$$$$$$$$$$$$$+$$$$$\
|$$$$$$$$$$$$$$$$$$$$$+$$$$$$\
|$$$$)$$$$$$)$$$$$$$$$$$$$$$$\
|^$$№$$$$$$$$$$$$$$$$$$$$$$$$\
|$)$$$$$$$$$$$$$)$$$$$$$$$$$$\
|$$$$$$№$$$$$$$№$$$$№$$$$$$$$\
|№$$№$$$$$$$$$$$$$$$$$$$+$$$$\
|$$$$$$$$№$$$$$$$$$$$$$$$$$$$\
|($$$$$$$$№$$$+$$$$$$$$^$$$$$\
|$$$$$$$$$$$$$$$$)$$$$$$$$$$$\
|@$$$$$$$$$$$$$$$$$($$$$$$$$$\
|$$$$$$+$$$$$$$$$$$$$$$$$$$$$\
|$$$$$$$$$$$$$$№$$$$$$+$$$$$$\
|$$$$$$$$$$$$$$@$$$$$$$$$$$$)\
|!!!!!!!!!!!!!!!!!!!!!!!!!!!!\